NO ./texture/no.xpm
SO ./texture/so.xpm
WE ./texture/we.xpm
EA ./texture/ea.xpm

F 220,100,0
C 225,30,0

111111
1E0001
1N0001
111111
