NO ./texture/no.xpm
SO ./texture/so.xpm
WE ./texture/we.xpm
EA ./texture/ea.xpm

F 220,100,0
C 225,30,0

11111111111111111111
1Q111111111111111111
11111111111111111111
11111111111111111111
