11111111111111111111
10000000000000000001
10011000000000000001
10011000000000000001
10000000000011000001
10000000000011000001
10000000000000000001
10000000000000000001
11111111111000000001
10000000001000000001
10000000001000000001
10000000001000000001
10000000001000000001
10000000001000000001
10000000001000000001
10000000000000000001
10000000000000000001
11111111111000000001
100N0000000000000001
11111111111111111111
NO ./texture/no.xpm
SO ./texture/so.xpm
WE ./texture/we.xpm
EA ./texture/ea.xpm
F 220,100,0
C 225,30,0
