NO ./texture/no.xpm
SO ./texture/so.xpm
WE ./texture/we.xpm
EA ./texture/ea.xpm

F 26,85,87
C 0,167,170

11111111111111111111
10000000000000000001
1001100000000W000001
10011000000000000001
10000000000011000001
10000000000011000001
10000000000000000001
10000000000000000001
11111111111000000001
10000000001000000001
10000000001000000001
10000000001000000001
10000000001000000001
10000000001000000001
10000000001000000001
10000000000000000001
10000000000000000001
11111111111000000001
10000000000000000001
11111111111111111111
