NO ./texture/no.xpm
SO				     ./texture/so.xpm
WE ./texture/we.xpm				               
   EA                      ./texture/ea.xpm				
F +26,085,000000000000000000000000000000000000000000000000000000000000000000000000000000000000000000000000000000000000000000000000000000000000000000000000000000000000000000000000000000000000000000000000000087
C 0   				    , 								167    ,                                                                                                                                                                                            170
11111
10001
10E01
10001
11111
