NO ./texture/no.xpm
SO ./texture/so.xpm
WE ./texture/we.xpm
EA ./texture/ea.xpm

F 220,100,0
C 225,30,0

11111111111111111111       
1N000000000000000001                    
10011111110000001111
10011    10000000001
10001111110011001111
10000000000011000001
10000000000000000001
10000000000000000001
11111111111000000001
10000000001000000001
10000000001000000001
10000000001000000001
10000000001000000001
10000000001000000001
10000000001000000001
10000000000000000001
11111111011111111111
       101         
11111111011111111111
11111111111111111111
