NO ./texture/no.xpm
SO ./texture/so.xpm
WE ./texture/we.xpm
EA ./texture/ea.xpm

F 220,100,0
C 225,30,0

            11111111111111111111       
            10000000000000000001                    
            10011000000000001111
                1001100000000001
            10000000000011001111
            10000000000011000001
            10000000000000000001
            10000000000000000001
11111111111111111111111000000001
            10000000001000000001
            10000000001000000001
            10000000001000000001
            10000000001000000001
            10000000001000000001
            10000000001000000001
            10000000000000000001
            10111111111111111111
                             101
            111111111111111111N1
            11111111111111111111
